NO image/carpet.xpm
SO image/carpet.xpm
WE image/carpet.xpm
EA image/carpet.xpm
F 0,0,0
C 155,155,155

1111
 101
1N11
1001
1111
        1
1111
1001
1001
1111