NO image/carpet.xpm
SO image/carpet.xpm
WE image/carpet.xpm
EA image/carpet.xpm

F 220,100,0
C 225,30,0

11111111   11111111
10000001   10000001
10000001   10000001
10000001   10000001
1000N001   10000001
10000001   10000001
11111111   11111111
