NO image/carpet.xpm
SO image/carpet.xpm
WE image/carpet.xpm
EA image/carpet.xpm

F 220,100,0
C 225,30,0

1111
1001
10W1
1111