NO ./image/pink_moulure_bridge_128.xpm
SO ./image/pink_moulure_telecabine_128.xpm
WE ./image/dark_pink_moulure_base_128.xpm
EA ./image/pink_moulure_base_128.xpm

F 230,111,111
C 245,144,144


111 111
 101101
1N1001 
 10001
1111111