NO ./image/pink_moulure_bridge_128.xpm
SO ./image/pink_moulure_telecabine_128.xpm
WE ./image/dark_pink_moulure_base_128.xpm
EA ./image/pink_moulure_base_128.xpm

F 230,111,111
C 245,144,144

 11111111111111111111111111111111111111111111111111111111111111111111111111111111111111111111
1000000000000000000000000000000000000000000000000000000000000000000000000000000000000000000001
1001000001000001000001000001000001000001000001000001000001000001000001000001000001000001000001
1000001000001000001000001000001000001000001000001000001000001000001000001000001000001000001001
1001000001000001000001000001000001000001000001000001000001000001000001000001000001000001000001
1000001000001000001000001000001000001000001000001000001000001000001000001000001000001000001001
1001000001000001000001000001000001000001000001000001000001000001000001000001000001000001000001
1000001000001000001000001000001000001000001000001000001000001000001000001000001000001000001001
1001000001000001000001000001000001000001000001000001000001000001000001000001000001000001000001
1000001000001000001000001000001000001000001000001000001000001000001000001000001000001000001001
1001000001000001000001000001000001000001000001000001000001000001000001000001000001000001000001
1E00001000001000001000001000001000001000001000001000001000001000001000001000001000001000001001
1001000001000001000001000001000001000001000001000001000001000001000001000001000001000001000001
1000001000001000001000001000001000001000001000001000001000001000001000001000001000001000001001
1001000001000001000001000001000001000001000001000001000001000001000001000001000001000001000001
1000001000001000001000001000001000001000001000001000001000001000001000001000001000001000001001
1001000001000001000001000001000001000001000001000001000001000001000001000001000001000001000001
1000001000001000001000001000001000001000001000001000001000001000001000001000001000001000001001
1001000001000001000001000001000001000001000001000001000001000001000001000001000001000001000001
1000001000001000001000001000001000001000001000001000001000001000001000001000001000001000001001
1001000001000001000001000001000001000001000001000001000001000001000001000001000001000001000001
1000001000001000001000001000001000001000001000001000001000001000001000001000001000001000001001
1001000001000001000001000001000001000001000001000001000001000001000001000001000001000001000001
1000001000001000001000001000001000001000001000001000001000001000001000001000001000001000001001
1001000001000001000001000001000001000001000001000001000001000001000001000001000001000001000001
1000001000001000001000001000001000001000001000001000001000001000001000001000001000001000001001
1001000001000001000001000001000001000001000001000001000001000001000001000001000001000001000001
1000000000000000000000000000000000000000000000000000000000000000000000000000000000000000000001
 11111111111111111111111111111111111111111111111111111111111111111111111111111111111111111111

