NO 		 	./image/carpet/carpet.xpm                            	 
SO 						./image/carpet/carpet.xpm
WE     	 	 	   ./image/carpet/carpet.xpm 	 
EA  	 		./image/carpet/carpet.xpm	 		 
F                     200,250,0	 	 	 
C 100,240,21	 	 	
	
111111111111111111111111
100010000000000000000001
100000100000000000000001
100000000100000000000001
10000000010000000N000001
100000000100000000000001
100010000100000000000001
100000000000000000000001
100000000000000000000001
100000000000000000000001
111111111111111111111111
