 111111
100101
1111 401
1101N1
111111