NO ./image/pink_moulure_bridge_128.xpm
SO ./image/pink_moulure_telecabine_128.xpm
WE ./image/dark_pink_moulure_base_128.xpm
EA ./image/pink_moulure_base_128.xpm

F 230,111,111
C 245,144,144

                        111111111111111111111111
                        100010000000000000000001
                        100001000000000001000001
                        100000100000000010000001
                        100000010000000100000001
                        100000001000001000000001
                        100000000100010000000001
                        100000000010100000000001
                        100000000001000000000001
                        100000000000000000000001
                        100000000000000000000001
 1111111111111111111111111111111111001111111111111111111111111111111111
100010000000000000000001100010000000000000000001100000000000000000000001
100000100000000000000001100000100000001000000000000001100001100001100001
100000000111001000000000000110000100000000010000000001100001100001100001
100000000100001000000000000110000000001000000001100000000000000000000001
1000000001000N1000000000000110000100000000010001100001100001100001100001
100010000111110000000000000110000000001000000001100000000000000000000001
100000000000000000000000000110000100000000010000000001100001100001100001
100000000000000000000001100000000000001000000000000001100001100001100001
100000000000000000000001100000000000000000000001100000000000000000000001
 1111001111110110111111 11111111111111111111111111111111111111111111111
111110011111011101111111
100010000000000000000001
100001110000000000000001
100000000000000000000001
100000000011110000000001
100000001100001100000001
100000010000000010000001
100000010000000010000001
100000001100001100000001
100000000000000000000001
 1111111111111111111111
