NO ./image/carpet.xpm
SO ./image/carpet.xpm
WE ./image/carpet.xpm
EA ./image/carpet.xpm
F 200
C 100

   1
  101
  101
11101111
10000001
10000001
1001100111111
10000000000001
100N000111111
10000001
11111111