NO image/carpet.xpm
SO image/carpet.xpm
WE image/carpet.xpm
EA image/carpet.xpm

F 220,100,0
C 225,30,0

11111111
1000N001
11101111
