NO ./image/carpet.xpm
SO ./image/carpet.xpm
WE ./../image/carpet.xpm
SE ./../image/carpet.xpm
F ./../image/carpet.xpm
C ./../image/carpet.xpm

111111
100101
111101
 1101N1
111111