NO ./image/carpet.xpm
SO ./image/carpet.xpm
WE ./image/carpet.xpm
EA ./image/carpet.xpm
F 200,,
C 100,,

111 111
 101101
111001 
 11001
1111N11