NO ./image/carpet.xpm
SO ./image/carpet.xpm
WE ./image/carpet.xpm
EA ./image/carpet.xpm
F 055,122,222
C 100,011,111

111 111
 101101
1N1001 
 10001
1111111