NO 
SO 
WE 
SE 
F 
C 




111111
100101
101001
1100N1
111111