NO ./image/carpet.xpm
SO ./image/carpet.xpm
WE ./image/carpet.xpm
EA ./image/carpet.xpm
F 200,,
C 100,,

111111111111111111111111
000010000000000000000001
100000100000000000000001
100000000100000000000001
10000000010000000N000001
100000000100000000000001
100010000100000000000001
100000000000000000000001
100000000000000000000001
100000000000000000000001
111111111111111111111111